IPA	Trs
p	p
b	b
t	t
d	d
c	c
ɟ	D
k	k
g	g
f	f
v	v
s	s
z	z
ʃ	S
ʒ	Z
ts	T
tʃ	J
ɲ	H
m	m
n	n
h	h
l	l
r	r
j	j

i	I
iː	i
y	Y
yː	y
ɛ	E
eː	e
œ	Ø
øː	ø
ɒ	A
aː	a
o	O
oː	o
u	U
uː	u